#################################################
#                        #     #      #         #
#         #              #     #      ###       #
#         #              #     #       #        #
E         #                            #        #
#         #                                     #
#         #  ###  ###  ###     #                #
#                              #                S
#################################################
