#################################################
#                                               #
#                   ###########~##~##~##~########
#######~#####       #                           E
S            #     #      #######################
#########   #       #     #                     #
#       #   #########     #                     #
#       #                 #                     #
#################################################
