##################################################################
#        #       #       #               #               #       #
#        #       #       #               #               #       #
#        #       ~       #               #               #       #
S        #       #       #               #               #       #
#        #               #               #               #       #
#        #       #       #               #               #       #
#        ~       #       #               #               #       #
#        #       #       ~       #       #       #       #       E
#        #       #       #       #               #               #
#        #       #       #       #               #               #
#        #       #       #       #               #               #
#        #       #       #       #               #               #
#                #       #       #               #               #
#        #       #       #       #               #               #
#        #       #               #               #               #
##################################################################
