#################################################
#                        #           #          #
#         #              #           ###        #
#         #              #     #       #        #
<=        #                    #       #       <=
#         #                    #                #
#                              #                #
#                              #                #
#################################################
