#################################################
#                        #     #      #         #
#         #              #     #      ###       #
#         #              #     #       #        #
<=        #                            #        # 
#         #                                     #
#         #  ###  ###  ###     #                #
#                              #               <=
#################################################
